wfc: ond mpw vsz
qxn: mow khk
nzf: rti sqv
ehm: von pgy fxk
nlt: pdl hwf
xqa: qvc cih
ghq: ren
jze: gbj
qrt: bug rxr plt cre vkd
vqt: kkx hbz ipe hiq
auk: out
vkq: lnb kyc
evj: jmy
ydi: goh gab tpj azd mlq fdi jom qii wyt
olh: qrt gbj
mmm: yfi dgv ppv wsf
zry: cne bqx nlt
lim: rlc gih
dac: ren cyv fnu
ufv: llo ydi
bkv: out
zne: dja jlj bzj wfc gms
gea: kwy stx kxt xmj
vjp: ngk
zpy: olh
gzb: zkz pti dog
hiq: sdq veq wss qxn whx
zeo: jci inl
lqm: lnb kyc
maq: ysa bft hcm
evv: lnb
ujm: udx uvu ntx ehm
may: toh
rin: ltg
vcs: yer
uop: xnm
fxk: hiq kkx hbz ipe
kqv: jpt rxd
nwx: kkx fnd hbz ipe
seq: uvu udx
iez: out
sii: vnk
you: fuz kat zup ffd kzl dpd rtn ftr qno
msu: you
huw: maq omi
qop: yfr fpt xar fzq
mcp: olh jkl
xzq: inl
ejj: nqh mmm
juq: tmi gzb zpk nxw
yrn: vnk
jdm: vye
fev: xot tez
wss: wyf
phg: xrc hcm bft
cpn: nsz upq tuc
jds: gpx
eca: pvz
qqm: fbj mtv sbo zwu
kkx: lci jcd pgv zry wqb veq doj hrm fli sdq
yqr: goy fnu
uvu: fxk czo
ufe: hiq kkx ipe hbz
qvc: yew nhj yag hnf jge
mbd: yzg rcm
bfy: xqd nzf
ral: jmy qbv rtk
cgh: qks xot alh
hwr: xar fzq
vvg: sym wdp khl
ofr: qhc
izc: dxc upp
jcd: khk cmh mow
xmj: wyc ygz
xqd: sqv rti ufs
htj: yqc tkl glz
kmo: kzi
piz: uyw yma pcg
zge: zag
vfm: kvk
uyw: obh
jom: zdm frc ojx jrd fjw
khk: bxi
fpt: pgl wvy
thw: lnb you
upq: uwr
kxd: zfc vex cxd tnl
rcm: toh hzk
mpw: zvf llo ydi
bep: ugq
pih: kxd jdx grs
yyr: sja fye
kic: ffp eeo wjb
jnx: wvy
eav: vnw lbn lpe
stx: ygz ngo bgs
nhj: fnd kkx hiq
bzj: ond mpw vsz
xsv: bxf zus wag rxu
ffd: vjp
vnw: enr ikg krf
agq: ofv
doj: zwu mtv
qew: nne fhl ahb
wnq: uvu ehm
ftr: xjl viv
gnm: tul jtm fft
veq: bqx
ily: vnk
bxi: bxf wag wtf
esu: otj lzl cgh
khl: kyn
goy: lnb you
mrd: you
ikt: ipe hiq
jci: xrc hcm
egf: jno rmv
ezq: may
vsg: qvc jgx
zfm: oag apc blg
ydr: xrc hcm
nly: llo zvf
xrc: vup mci xqa qhh vsg dqt vrt yyr vfm pxk nkv
uvb: nwx
ual: myr krv
dja: vsz mpw
qeb: kkx ipe hbz hiq
tys: jci rio
aib: tys zeo gnt
rtn: jpt vjp
jnh: qvl byz xpt ibx
xjl: jds
ogd: aji ral use
sdq: yqr any bgj
pec: ipe
fqv: ugq
svb: kyc
rpw: itt qsb
gpx: nzf sgh xqd
mow: ohg bxi
csk: vvg hsf
von: ipe fnd
qhh: ibx
wmw: tqi ber doh
dqt: cih
yqc: bft hcm ysa
bsq: jdm kzi rir nxk
owb: lmw htj ofv
yag: kkx
fhl: sjq sbz
hyp: kyc you
tez: bkx
thx: ofr zeo
vfb: jde ofo
tuc: jrz vqt
joi: smo afx
sqs: nax jgl joi
wvy: toh vnk hzk
xlf: fnd
lay: vey pkr
gnt: jci rio qhc
rmv: uwf fqb
bwk: sja jiv
duc: you lnb kyc
fqb: out
uxn: jgx cih
gia: rxd vjp
kgl: die vkq
ufs: out
kvy: zua
thi: out
wsf: twk
oag: mym zua
bxf: vin msu loy
gxy: jds smg xqh
hzl: egf inc
zup: ejj
kml: uvb myr
deb: wlw cpn dka
xjb: wkv ejj qpn
nnk: ugk
lzm: jjv
bum: upk shw egy
dlb: sii hay ltg rgb
jrd: phg kou nql
nkv: lvv upp dxc
gab: ztn cdj
wyc: pkr qpq vey
jta: kkx fnd hbz ipe
alh: bkx ltx hze
wlw: tuc
uvh: ydi zvf llo
igw: qvl byz
uep: aib
lpe: ikg enr krf crd
vda: rlc gih xvx
qno: xmj kxt omo stx kwy
qii: frc fjw
jdx: tnl fum vex
wkv: nlc rje nqh
qhj: jjv
fpk: xvx
rxu: loy msu vin lqm
wey: mjb qew rcv ora oad yqa ptp tvr fcu zgf bcz dmd jca dmw gfv itk pka
ahf: giq qvw ajg
jgl: afx zfk smo kgl
lmw: glz tkl
gwf: vnk toh
fpr: hcm ysa
hze: qsp uyb
xar: sha wvy
yun: ojx zdm
esd: vnw cbv lpe
hnf: fnd kkx
omi: bft hcm ysa xrc
cmh: ohg uih xsv
sao: out
noa: bkv fct cqx
mlq: tlg
ngo: qpq vey
jge: hiq hbz fnd kkx
fba: you kyc
nsz: vqt jrz
qkr: thi iez
cqx: out
ugq: nnn
wxo: lmw htj
uwr: kkx fnd ipe
rsz: jpt rxd
mjb: bff nze
xun: llo zvf ydi jhh
dpn: xnx
agk: wpb gnm ugk
ptp: jcw fpk vda lim
euq: auk
oad: fhl ahb yep nne
dwr: jnx yfr
kux: eqw
tpj: fjw zdm frc
qpq: noa ijb
vsz: jhh ydi
oaa: tmp ehl
mci: dxc lvv
lgn: eca esv egf inc
axf: xrb dhn vsl fxs
qsp: auk doh
jtm: jdx htf
kpy: eeo ffp
cwo: jze jkl
pgv: cne
lci: joi jgl
crd: zvf llo
qks: hze
uih: wtf zus
krv: qeb
vtg: hzk vnk toh
ldy: ysa xrc bft hcm
ykn: llo ydi jhh
obh: vyp yer
rti: out
twk: vsl fxs xrb dhn pkx
lxk: htj lmw
any: goy fnu
zua: rrf jde ofo
inl: ysa
ljh: aji
vhk: vnw lpe cbv
hcm: nkv igw xqa izc awr
sgh: rti sqv
ypr: fxs
mdu: sii ltg
hrm: nax
kfo: pka nek dmd jca gfv dmw itk tvr juq zgf mjb qew bum oad ora
zpk: oaa
enr: llo ydi
gfm: ufe
rct: jjv wnu
oqj: fqb
pka: zpk ykm tmi gzb
ove: dja jlj wfc gms
gyr: wpb
yew: kkx ipe hbz hiq
fnd: doj veq gey wqb fjr ppw whx
mgv: krv uvb
blg: zua vfb mck
ofv: tkl glz sxb
tkt: ord
eqw: hzk
ead: aib thx htk
vnk: jvj agk eav vsk tql vhk zne zge rct ogd dpn nuo ljh qhj nfv ove qck tvi qnw vmf lzm nnk gjj oxu
ojx: nql phg
dag: lnb you
nlk: cgh
jlj: vsz ond
rrf: fpr tde maq
cko: jjv wnu gcq
plm: lug cwo
sjq: ezq ahf owp
vin: you kyc lnb
ldb: kvy apc tlg oag
ltx: euq wmw uyb tmg qsp
yep: sbz sjq
fxs: out
ehl: luj rcm yzg
tmi: imc zkz pti oaa
jcw: xvx
syi: kwy omo kxt
lvv: zgq xlf ikt
tlg: vfb
bfl: yrn
dtz: otj fev cgh lzl
dxc: xlf zgq
ylj: iab kic
yfr: wvy
txz: ltg hay rgb
wbq: blg apc kvy
vkd: hcm
yyv: vtg
wft: etd hsf fqv vvg
bcz: qop dwr
vmf: gcq
qhc: bft hcm
grs: vex zfc tnl cxd fum
rjj: ntx uvu
wib: duc
acd: kyc
cbv: enr
cdj: rpw rja xnm dnb
jhh: zfm ead owb myy qii uep agq rji mlq fdi plm yun lxk goh vmc ldb gab tpj
bft: vfm izc vrt yyr igw dqt jnh vsg vel bwk uxn nkv pxk deb xqa mci awr vup fah
sym: kyn jdt
czo: fnd hbz
otj: alh xot qks
rcv: bff nze
tnl: zvf
jca: pyi kux
nsh: gxy
rxd: ngk hzl
zus: evv loy vin
zfk: hyp vkq
afx: vkq die mrd fba
flm: yqr dac ghq bgj
nne: sjq zev
ohg: wtf wag
dmd: xxk
yqa: pyi kux
omo: lay
krf: jhh
lnb: zwb piz nsh gea wef nlk fuz dtz gia kqv
knl: fyd uvu udx
fah: ylj
ffp: tfw pec
vel: wlw dka
qxd: van ulx qkr
zkz: tmp ehl
qvw: vnk
lzl: tez xot alh
llo: gab tpj wbq ldb vmc wxo wyt goh qtw lxk yun plm azd fdi rji agq myy owb zfm qii uep rry
doe: svb pdd duc
yje: qvw giq
zcu: jhh
ppv: ypr jdg axf
xnx: fqv
fli: doe vwj wib wyf
fcu: nne
plt: ysa hcm
xpt: kml ual mgv qrq
jde: tde fpr
jdg: dhn pkx vsl fxs
wnu: tkt kmo dyq
zwu: acd
fuz: kwy xmj
iab: sli
jjv: bsq dyq kmo nhd
kzi: vye ufv xun zcu
dog: kfe tmp kvo
dgv: axf jdg
wtf: loy
kwy: ygz
rgb: hzk toh
bqx: hwf pdl thw mqb dag
nax: zfk afx
gmw: kyc you
fte: yma
dhn: out
pdl: lnb
cne: mqb thw
nnn: zvf
lbn: ykn ikg
ahb: zev sjq
nze: jnx fpt xar
tvr: qop
ord: nly vye xun zcu
pdd: you lnb
qtw: kvy apc blg
dka: upq nsz
ofo: tde maq
viv: smg xqh
shw: dlb
dnb: itt
rtk: vjr uvh
tde: bft xrc
jrz: hbz
vqi: goo iab xkx kic
dyq: nxk rir jdm
lky: oad ora rcv bum mjb rpx zgf juq fcu tvr ptp itk gfv dmw jca pka nek iuz
nxk: xun zcu nly vye ufv
iib: thi jlm
vsk: wfc
ren: you kyc lnb
qsb: ldy
goo: gfm eeo ffp sli
rlt: cre plt vkd rxr
pyz: nsz tuc
nfv: upi
amu: sgh
yed: ghq dac yqr
qck: hap
tul: grs ymg
sha: toh
bkx: tmg euq
cyv: you lnb
ugk: pih jtm tul fft
tfw: hiq ipe kkx fnd
zfc: ydi
ykm: zkz pti imc
lug: jze jkl
tkl: hcm ysa xrc
sja: seq ujm knl rjj
yer: qkr iib ulx
aji: kbv jmy qbv rtk
mtv: gmw
wef: viv gxy xjl mdc
pfx: hiq fnd
nhm: qxd
svr: lky kfo bet wey
ntx: czo von pgy fxk
tvi: gms dja jlj
eeo: tfw ufe pfx pec jwa
myr: qeb jta nwx
nhd: nxk jdm
vwj: duc svb
gfv: pyi yyv
ora: ahb fhl
jlm: out
esv: rmv jno pvz
pok: vnk
xxk: rin txz
htk: zeo ofr tys xzq gnt
ysa: fah qhh xqa vup mci nkv uxn vel bwk pxk igw vrt yyr ngj izc vfm jnh dqt
zgf: hwr bff qop dwr
sgc: evj
zdm: phg kou
qvl: ual kml mgv
htf: tnl cxd zfc vex
nxw: dog pti zkz imc
hwd: bkv sao cqx fct
xkx: eeo gfm
kvo: rcm gwf luj
bgs: pkr qpq
fct: out
mrl: cmh
jkl: qrt rlt gbj
fdi: thx
rje: yfi dgv auw
use: jmy qbv rtk
bff: fzq
xqh: bfy
vup: ylj vqi
mkh: hcm bft
jmy: vjr emc
gbj: vkd rxr bug
azd: qgv zpy lug
mck: ofo jde huw rrf
upp: ikt zgq
wjb: jwa pfx
yfi: twk jdg
apc: vfb zua mym
frc: nql
rji: zpy cwo lug
upk: rin mdu
ngk: inc egf esv
auw: jdg ypr twk
pkr: noa hwd
sli: ufe tfw
jwa: hbz fnd
egy: mdu dlb rin
fye: rjj wnq seq
vey: hwd ijb noa
hsf: khl wdp sym
bgj: cyv
wpb: lts fft jtm tul
cxd: zvf
xot: bkx ltx
itt: egq mkh ydr
qnw: lbn vnw cbv
jvj: ral use
pyi: eqw ily vtg
oxu: zag wft xnx csk
rry: ztn cdj
smg: gpx bfy amu
fzq: sha
yma: nhm vcs
hay: toh vnk
egq: ysa bft
upi: lts jtm
uyb: ber
vye: ydi jhh zvf
jpt: hzl lgn
ijb: cqx sao bkv
fbj: gmw acd
udx: czo von
rqt: kwy omo xmj
etd: ugq wdp
mym: jde huw rrf
ber: out
nqh: auw wsf dgv yfi
hwf: kyc
rir: ufv
ygz: vey
bug: hcm xrc ysa
jiv: wnq knl ujm
rlc: vnk toh
ltg: hzk toh
gjj: gnm upi wpb
uwf: out
ond: zvf ydi
wqb: fbj
ppw: doe
kyc: gea zwb fte rtn ftr rqt esu ffd hdx gia rsz kqv fuz syi piz wef qno xjb kat nlk zup dtz
byz: kml mgv qrq
wyf: svb pdd
vaq: egq ydr
fjw: nql phg
zev: ezq bfl ahf owp yje
zvf: mlq agq rji rry uep myy ead lxk qtw yun plm jom vmc wxo wyt tpj wbq ldb
xrb: out
rio: hcm bft ysa
imc: kfe
xnm: vaq itt
wyt: uop cdj ztn
ngj: wlw pyz
wag: msu
fnu: lnb you
kyn: jhh ydi llo
nuo: csk
tmp: luj pok rcm yzg
ipe: yed fjr flm sqs qxn lci qqm fli hrm mrl zry
ztn: rja rpw dnb xnm
iuz: jcw fpk vkv lim vda
nql: xrc ysa hcm bft
pvz: hid
pgy: kkx fnd hbz
ymg: cxd tnl
pgl: toh hzk
dmw: ahb nne
vjr: zvf jhh
vyp: ulx iib qkr
smo: mrd die vkq hyp
pkx: out
sbz: yje owp ahf bfl
tql: dja
dpd: cki wkv qpn
owp: giq
cih: nhj hnf jge
ikg: jhh llo
cre: xrc ysa bft
toh: ove tvi qck vmf qnw lzm nnk cko oxu gjj jvj eav agk vsk tql vhk sgc gyr esd zge zne rct ogd qhj ljh
tmg: ber auk doh
qpn: rje mmm nqh
bet: bcz dmd dmw itk iuz nek mjb rpx qew rcv oad ora yqa ptp tvr juq zgf
die: lnb
hzk: gjj nuo oxu nfv qhj lzm rct ogd dpn nnk vmf gyr sgc vhk zne ove agk vsk tvi qck
jgx: yag nhj yew hnf
mqb: lnb
zag: bep etd fqv
vrt: dxc
goh: lug qgv cwo
tqi: out
gms: mpw
gcq: bsq kmo nhd tkt
zgq: hbz fnd kkx
nek: tmi zpk ykm
rxr: hcm bft
lts: grs jdx kxd htf
jno: hid fqb
vvf: lnb
awr: sja jiv fye
kvk: kpy kic goo
pti: tmp kfe mbd
fum: jhh ydi llo zvf
fft: kxd htf
sbo: acd gmw vvf
glz: hcm xrc ysa
vmc: qgv cwo mcp lug
pxk: wlw cpn dka
kat: qpn
sxb: xrc ysa bft
hdx: pcg
rpx: xxk egy shw
emc: llo jhh
luj: toh
vsl: out
jdt: jhh ydi zvf
kxt: bgs
qgv: jze jkl olh
rja: vaq itt
inc: oqj pvz
vkv: rlc xvx
fyd: fxk pgy von
giq: toh hzk vnk
van: thi jlm
yzg: hzk vnk
xvx: hzk
kou: xrc ysa bft
qrq: uvb krv
kzl: viv mdc
fjr: joi
qbv: uvh emc
loy: you
pcg: nhm vcs
whx: nlt bqx cne
ajg: toh hzk
ulx: jlm iez
kfe: gwf yzg
ulb: qks xot tez
itk: vkv fpk jcw
cki: nlc
nlc: ppv
gih: vnk hzk
myy: htk
gey: cmh
doh: out
ibx: qrq
mdc: smg
hap: jmy
zwb: ulb
kbv: vjr uvh
hbz: sqs qxn jcd qqm yed
sqv: out
wdp: kyn nnn
vex: llo jhh ydi
hid: out